//MAP CONVERTED BY dmm2tgm.py THIS HEADER COMMENT PREVENTS RECONVERSION, DO NOT REMOVE
"a" = (
/turf/unsimulated/bombvr,
/area/sim/test_area{
	name = "VR Test Area"
	})
"g" = (
/turf/unsimulated/wall/generic{
	icon = 'icons/obj/singularity.dmi';
	icon_state = "TheSingMain";
	name = "v-space"
	},
/area/sim/test_area{
	name = "VR Test Area"
	})
"k" = (
/obj/landmark{
	name = "bombtest-bomb"
	},
/turf/unsimulated/bombvr,
/area/sim/test_area{
	name = "VR Test Area"
	})
"t" = (
/obj/landmark{
	name = "bombtest"
	},
/turf/unsimulated/bombvr,
/area/sim/test_area{
	name = "VR Test Area"
	})
"w" = (
/turf/unsimulated/wall/bombvr,
/area/sim/test_area{
	name = "VR Test Area"
	})
"V" = (
/obj/death_button/VR_logout_button{
	dir = 1;
	pixel_y = -24
	},
/turf/unsimulated/bombvr,
/area/sim/test_area{
	name = "VR Test Area"
	})

(1,1,1) = {"
g
g
g
g
g
g
g
g
g
g
g
g
g
g
g
g
g
g
g
g
"}
(2,1,1) = {"
g
a
a
a
a
a
a
a
a
a
a
a
a
w
a
a
a
a
a
g
"}
(3,1,1) = {"
g
a
a
a
a
a
a
a
a
a
a
a
a
a
a
a
a
a
a
g
"}
(4,1,1) = {"
g
a
a
a
a
a
a
a
a
a
a
a
a
w
a
a
a
a
a
g
"}
(5,1,1) = {"
g
a
a
a
a
a
a
a
a
w
w
w
w
w
a
a
a
a
a
g
"}
(6,1,1) = {"
g
w
w
w
w
w
w
w
w
w
a
a
a
a
a
a
a
a
a
g
"}
(7,1,1) = {"
g
a
a
w
a
a
a
a
a
w
a
a
a
w
w
a
w
a
a
g
"}
(8,1,1) = {"
g
a
a
w
a
a
a
a
a
a
a
a
a
w
a
a
w
a
a
g
"}
(9,1,1) = {"
g
a
a
w
a
a
a
a
a
w
a
a
a
w
a
a
w
a
a
g
"}
(10,1,1) = {"
g
a
a
w
a
a
w
w
w
w
w
w
w
w
a
a
w
a
a
g
"}
(11,1,1) = {"
g
a
a
w
a
a
w
a
a
a
a
a
a
w
a
a
w
a
a
g
"}
(12,1,1) = {"
g
a
a
a
a
a
a
a
a
a
a
a
a
w
a
a
w
a
a
g
"}
(13,1,1) = {"
g
a
a
w
a
a
w
a
a
a
a
a
a
w
a
V
w
a
a
g
"}
(14,1,1) = {"
g
a
a
w
w
w
w
a
a
a
a
a
a
w
a
a
w
a
a
g
"}
(15,1,1) = {"
g
a
a
a
a
a
w
a
a
a
k
a
a
a
a
t
w
a
a
g
"}
(16,1,1) = {"
g
a
a
a
a
a
w
a
a
a
a
a
a
w
a
a
w
a
a
g
"}
(17,1,1) = {"
g
a
a
a
a
a
w
a
a
a
a
a
a
w
a
a
w
a
a
g
"}
(18,1,1) = {"
g
a
a
a
a
a
w
a
a
a
a
a
a
w
a
a
a
a
a
g
"}
(19,1,1) = {"
g
a
a
a
a
a
w
a
a
a
a
a
a
w
a
a
w
a
a
g
"}
(20,1,1) = {"
g
w
w
a
w
w
w
w
w
w
a
w
w
w
a
a
w
a
a
g
"}
(21,1,1) = {"
g
a
a
a
a
a
a
a
w
a
a
a
a
a
a
a
w
a
a
g
"}
(22,1,1) = {"
g
a
a
a
a
a
a
a
w
a
a
a
a
a
a
a
w
a
a
g
"}
(23,1,1) = {"
g
a
a
a
a
a
a
a
a
a
a
a
a
a
a
a
w
a
a
g
"}
(24,1,1) = {"
g
a
a
a
a
a
a
a
w
a
a
a
a
a
w
w
w
w
a
g
"}
(25,1,1) = {"
g
a
a
a
a
a
a
a
w
a
a
a
a
a
w
a
a
a
a
g
"}
(26,1,1) = {"
g
a
a
a
a
a
a
a
w
a
a
a
a
a
w
a
a
a
a
g
"}
(27,1,1) = {"
g
a
a
a
a
a
a
a
a
a
a
a
a
a
w
a
a
a
a
g
"}
(28,1,1) = {"
g
a
a
a
a
a
a
a
w
a
a
a
a
a
w
a
a
a
a
g
"}
(29,1,1) = {"
g
g
g
g
g
g
g
g
g
g
g
g
g
g
g
g
g
g
g
g
"}
