//MAP CONVERTED BY dmm2tgm.py THIS HEADER COMMENT PREVENTS RECONVERSION, DO NOT REMOVE
"a" = (
/turf/unsimulated/floor/vr/checker,
/area/space)
"O" = (
/turf/unsimulated/wall/blackwall,
/area/space)

(1,1,1) = {"
O
O
O
O
O
O
O
O
O
O
O
O
O
O
O
O
"}
(2,1,1) = {"
O
a
a
a
a
a
a
a
a
a
a
a
a
a
a
O
"}
(3,1,1) = {"
O
a
a
a
a
a
a
a
a
a
a
a
a
a
a
O
"}
(4,1,1) = {"
O
a
a
a
a
a
a
a
a
a
a
a
a
a
a
O
"}
(5,1,1) = {"
O
a
a
a
a
a
a
a
a
a
a
a
a
a
a
O
"}
(6,1,1) = {"
O
a
a
a
a
a
a
a
a
a
a
a
a
a
a
O
"}
(7,1,1) = {"
O
a
a
a
a
a
a
a
a
a
a
a
a
a
a
O
"}
(8,1,1) = {"
O
a
a
a
a
a
a
a
a
a
a
a
a
a
a
O
"}
(9,1,1) = {"
O
a
a
a
a
a
a
a
a
a
a
a
a
a
a
O
"}
(10,1,1) = {"
O
a
a
a
a
a
a
a
a
a
a
a
a
a
a
O
"}
(11,1,1) = {"
O
a
a
a
a
a
a
a
a
a
a
a
a
a
a
O
"}
(12,1,1) = {"
O
a
a
a
a
a
a
a
a
a
a
a
a
a
a
O
"}
(13,1,1) = {"
O
a
a
a
a
a
a
a
a
a
a
a
a
a
a
O
"}
(14,1,1) = {"
O
a
a
a
a
a
a
a
a
a
a
a
a
a
a
O
"}
(15,1,1) = {"
O
a
a
a
a
a
a
a
a
a
a
a
a
a
a
O
"}
(16,1,1) = {"
O
O
O
O
O
O
O
O
O
O
O
O
O
O
O
O
"}
